  ######
###   P#
#  XO  ##
#  OXO  #
###  X  #
  #   ###
  #####
