  ####
  #OO#
 ## O##
##  XO#
#  X  ##
#  #XX #
#  P   #
########
