   ######
####    #
#OPX    #
### XO  #
#O##X   #
# # O   #
#X   XXO#
#    O  #
#########
