  #######
  #     #
###XXX  #
#P XOO  #
# XOOO  #
####  ##
   ####
