 |A B C D E F G H
-+---------------
1|. 5 5 5 5 5 . .
2|. . . . . . . .
3|. . . 2 2 . . .
4|. . . . . . . .
5|. 3 . . . . . .
6|. 3 . . . . . .
7|. 3 . 4 4 4 4 .
8|. . . . . . . .
